NO /home/kali/project/textures
SO /home/kali/project/textures
EA /home/kali/project/textures
WE /home/kali/project/textures

1111111111111111111111
1000000000000000000001
1001100011111111000001
1000000000000000000001
1000E00000000000000001
1000001111000000011101
1111111111111111111111