C 37,150,190 
F 234,182,118

SO ./textures/maria.png
NO ./textures/lady.png
WE ./textures/man.png
EA ./textures/horse.png

        111111111111111111111111
111111111100100000000000000000001         
10010000000S00000000000111111111
100100000000000000000001
111111100100000011100001
100000000011000011101111
111101111111101110000001
111101111111110111011001
110000001101010111000001
100000000000000110000011
100000000000000011011111
10000001110111111 111111
100111101111011111111111
101101111110101101111001
111111111111111111111111