C 37,150,190 
F 234,182,118

SO ./textures/one.png
NO ./textures/one.png
WE ./textures/three.png
EA ./textures/four.png

111111111111111111111111
100100000000000000000001
100100000000000000000001
100100000000000000000001
111111100100000011100001
100000000011000011101111
111101111111101110000001
111101111111110111011001
110000001101010111000001
100000000000000110000011
100000000000000011010111
100000011101010111101111
1S1101111110101101111001
111111111111111111111111
