1111111111111111111111
1000000000000000000001
1001100011111111000001
1000000000000000000001
100000000000W000000001
1000001111000000011101
1111111111111111111111