C 0,0,0
F 0,0,255

SO /home/kali/project/textures/ida0.png
NO /home/kali/project/textures/ida0.png
WE /home/kali/project/textures/ida0.png
EA /home/kali/project/textures/ida0.png

        1111111111111111111111111
        1000000000110000000000001
        1011000001110000000000001
        1001000000000000000000001
111111111011000001110000000000001
100000000011000001110111111111111
11110111111111011100000010001
11110111111111011101010010001
11000000110101011100000010001
10000000000000001100000010001
10000000000000001101E10011111
11000001110101011111011110111
11110111 1110101 101111011111
11111111 1111111 111111111111
11111111 1111111 111111111111