C 37,150,190 


F 234,182,118

SO ./textures/one.png
NO ./textures/one.png
WE ./textures/three.png
EA ./textures/four.png

1111111111111111111111111
1S00000000110000000000001
1011000001110000000000001
100100000000000000000000111111111
111111111011000001110000000000001
100000000011000001110111111111111
11110111111111011100000010001
11110111111111011101010010001
11000000110101011100000010001
11000000110101011100000010001
10000000000000001100000010001
11000000110101011100000010001
10000000000000001100000010001
11000000110101011100000010001
10000000000000001100000010001
11000000110101011100000010001
10000000000000001100000010001
11000000110101011100000010001
10000000000000001100000010001
10000000000000001100000010001
11000001110101011111011110111
10000000100000001101000011111
11110111 1110101 101111011111
11110111 1110101 101111011111
11111111 1111111 111111111111